impassable = {
698 699 2180 2181 2183 1838 2143 2144 703 2136 4194 688 692 1836 2141 2142 4196 689 700 2179 4198 690 691 2138 2139 2140 693 694 697 2177 2178 695 696 2137 4195 687 2175 2176 707 708 2182 2184
727 728 2185  4200 4660 1049 2103 2104 4659 4662 1850 2106 2186 4655 4656 704 726 2112 2113 4652 2107 2108 4653 4654 4661 1048 1050 4214 4215 4216 1033 4658 729 731 2105 4217 4663 730 2110 2111 2188 4201 724 1053 2102 4664
667 2156 2157 2158 669 1829 2152 2153 664 1840 2162 2163 2164 681 682 2171 2172 4197 671 672 2173 2174 670 683 1833 2151 686 2146 2147 685 1821 1822 2145 738 2154 2155 665 666 2159 2160 2161 684 1824 2148 2149 2150
705 706 2134 4204 565 4481 4482 678 2131 2132 2133 2135 2128 4516 4520 676 4514 4515 4518 677 2130 4205 4517 4519
2169 2170 4211 675 2168 2748 4213 679 680 4212 660 661 2165 2166 2167 662 663 673 674 4199
1029 1839 4188 4360 1027 4190 4191 1031 1032 1847 1852 4193 1023 1024 1837 1020 1021 1832 4187 1014 1818 4182 4651 1018 1830 4183 4185 1017 1019 1825 4184 1819 1820 4186 1012 1015 4180 4181 1025 1026 4131 4192 1030 1835 4359 1028 1843 4189
734 736 2694 2745 4227 732 2742 2743 1845 2744 4232 737 1013 2741 4228 4229 733 735 4230 4231
722 2115 4203 4672 4675 725 4218 4665 2109 2187 4202 4674 720 2193 4221 4669 4677 702 2114 2747 4670 4671 718 2117 4222 4680 4682 714 2118 2119 4681 4684 701 709 2191 4223 4676 717 721 2116 4220 713 715 2120 4208 4683 716 1065 1066 4679 2122 4206 4207 719 2189 2190 4668 4678 1058 4667 4666 4219 4673 723 2123 711 4693 2192 2121 712 710 2124 4209
}
